################################################
#####                                          #
## @                                           #
#############  ###################  ############
#           #                                  #
#  #####################  ######################
#                                              #
#########   #########  #########################  
#                  #             #             #
#############      ###########                 #
#           #      #             #             #
#############      #  ########################## 
#                  #                           #
#############  ##################              #
#                           #                  #
#################  ##########  #################
#                                              #
########  ##################################   #
#                           #                  #
######################  ##########  ############
#                           #           #      #
#                #                      #      #
##############   ###############################
#                                              #
###  ###########################################
#                    #      #       #       $ ##
#                      #        #      #   #####
################################################
