################################################
#    # @ #        #########                    #
#    #   #        #########                    #
#    #   #                                     #
#                                              #
#                                              #
#  #  #########################   ###   ####  ##
#  #  #        ###############     #     # #   #
#  #  #        #             #     #     # #   #
#  #  ##########   #######   #     #     # #   #
#  #           #   #     #   #     #     # #   #
#  #########   #   #     #   #           # #   #
#          #   #   #  #  #   #    ######## #   #
########   #   #   #  #  #   #    #        #   #
#      #   #   #   #  #  #   #    #        #   #
#      #   #       #  #  #   #    #   ######   #
#      #   #       #  #  #   #    #   #        #
#      #   #########  #  #   #    #   #  #######
#      #     #        #  #   #    #   #  #     #
####   ##  #####  #####  #   #    #   #  #     #
#       #    #        #  #   #    #   #  #     #
#       #    ######   #  #   ######   #  #     #
#       #             #  #            #  #     #
#       #             #  #            #  #     #
#       ###########   #  ####  #####  ######   #
#                     #            #       #   #
#                     ################## $ #   #
################################################
