################################################
#  @                                           #
#####################       ####################
#                       #                      #
#   ########################################   #
#                       #                      #
#####################   #  ########   ##########
#                       #   #                  #
#   #####################   ################   #
#   #                   #   #                  #
#   #  #######          #   #   ################
#   #  #     ########   #   #                  #
#   #       #           #   ################   #
#   #      #    #########                      #
#   ########            ###   ##################
#                       #                      #
################        #                      #
#              ######   #########  #############
#   ########   #        #                      #
#   #      #   #   #########################   #
#   #      #   #        #                      #
#   #      #   ######   #   ####################
#          #            #                      #
#          #################################   #
#   #                   #                      #
##########   ###################################
#                                           $  #
################################################
