################################################
#  @                  #####                    #
############     ###############################
#                                              #
#   ########################################   #
#                       #                      #
#####################   #  ########   ##########
#                       #   #                  #
#   #####################   ################   #
#   #                   #   #                  #
#   #  #######          #   #   ################
#   #  #     ########   #   #                  #
#   #       #           #   ################   #
#   #      #    #########                      #
#   ########            ###  ###################
#                       #     #                #
################        #                      #
#              ######   #########  #############
#   ########   #        #                      #
#   #      #   #   #########################   #
#   #      #   #        #                      #
#   #      #   ######   #   ####################
#   #      #            #                      #
#   #      #################################   #
#   #                   #                      #
#   ######   ############   ####################
#                                           $  #
################################################
