################################################
#  @                    #                      #
##############          #                      #
#                          #####################
#  ######################                      #
#                      ##  ######     ##########                                                                            
###########  ############  #       #  #        #
########               #############           #        
#####     #####                 #  #  ##########
#######   ###################   #  #  #       ##
#             #             #      #  #       ##
############  #  #########  ########  #   ######
#                #                    #   #    #
###############  ##  ##################        #
###############  ##  ####        ##########    #
#                #      #        #       $#    #
#            #   #      #######  #  #######    #
######  ######                   #        #    #
#    #  #    ##################  ######        #
#    #  #                        #        #    #
#    #  #                        #  #######    #
#    #  #  #######  ##############        #    #
#    #  #        #                        #    #
#    #  ##########  #######################    #
#    #                                         #
#    ###########  ##############################
#                                              #
################################################
