################################################
#####                #######                   #
## @                 #######                   #
#############   ##################  ############
#           #                                  #
#  ##########                                  #
#                                              #
#########   #########  ###########             #
#           #      #             #             #
#############      ############  #             #
#           #      #             #             #
#           #      #  #######################  # 
########    #      #                           #
#                  ##############              #
###############             #                  #
#                  ##########  #################
#                           #                  #
########  ##################################   #
#                           #                  #
######################  ##########  #######    #
#                           #           #      #
#                #                      #      #
##############   ###############################
#                                              #
###  ###########################################
#                    #      #       #       $ ##
#                      #        #      #   #####
################################################
