################################################
#                 #########        #@#         #
#                 #########        # #         #
#                    ##           ## ########  #
#                                              #
#                    #                         #
#  #  #########################   ###   ####  ##
#  #  #        ###############     #     # #   #
#  #  #        #             #     #     # #   #
#  #  ##########   #######   #     #     # #   #
#  #           #   #     #   #     #     # #   #
#  #########   #   #     #   #           # #   #
#          #   #   #  #  #   #    ######## #   #
########   #   #   #  #  #   #    #        #   #
#      #   #   #   #  #  #   #    #        #   #
#      #   #       #  #  #   #    #   ######   #
#      #   #       #  #  #   #    #   #        #
#      #   #########  #  #   #    #   #  #######
#      #     #        #  #   #    #   #  #     #
####   ##  #####  #####  #   #    #   #  #     #
#       #    #        #  #   #    #   #  #     #
#       #    ######   #  #   ######   #  #     #
#       #             #  #            #  #     #
#       #             #  #            #        #
#       ###########   #  ###########  ######   #
#                     #            #       #   #
#                     ################## $ #   #
################################################
