################################################
#                ########  #####################
##########   #   ########                      #
#            #             ######  #########   #
#   @        ####  ######             #        #
#                      ##  #          #  #######                                                                            
###########  ############          #  #        #
########      #   ########  #####  #  ##########        
#####     #####                 #  #  ##########
#####   #####################   #  #  #       ##
#             #             #   #  #  #       ##
#####   #####################   #  #  #     $ ##
#             #             #   #  #  #       ##
############  #  #########  ##  ####  #   ######
#                #              #     #   #    #
###############  ######################   #    #
###############  ########        #######  #    #
#                #      #        #        #    #
#            #   #      #######  #  #######    #
######  ######                   #        #    #
#    #  #    ##################  ######  ##    #
#    #  #  ####################  #        #    #
#    #  #                        #  #######    #
#    #  #  #######  ####  ########        #    #
#    #  #        #  #                     #    #
#    #  ##########  #######################    #
#    #                                         #
#    ######################################    #
#                                              #
################################################



