################################################
#####                                          #
## @                                           #
#############  ###################  ############
#           #                                  #
#  ##########                                  #
#                                              #
#########   #########  ###########             #
#           #      #             #             #
#############      ############  #             #
#           #      #             #             #
#           #      #  #######################  # 
########    #      #                           #
#                  ##############              #
###############             #                  #
#                  ##########  #################
#                           #                  #
########  ##################################   #
#                           #                  #
######################  ##########  ########   #
#                           #           #      #
#                #                      #      #
##############   ###############################
#                                              #
###  ###########################################
#                    #      #       #         ##
#                      #        #      #   #####
################################################
