################################################
#                                          #   #
############################################   #
#                                            @ #
#  #############################################
#                                              #                                                                            
###########################      ###########   #
#                                              #        
#  #############################################                                              
#                                              #                                              
#######################     ################   #
#                                              #
#  #############################################
#                                              #
###################     ####################   #
#                                              #
#  ######    ###################################
#  #                                           #
#  #                                           #
#   #####################################      #
#                                              #
#  ######################################      #
#  #                                           #      
#  #                                           #
#  ##########################    ###############
#                                             ##
#                                           $ ##
################################################

