################################################
#  @                    #                      #
##############          #                      #
#            #             #####################
#  ######################                      #
#                      ##  ######     ##########                                                                            
###########  ############  #       #  #        #
########               ##  ######  #           #        
#####     #####                 #  #  ##########
#######   ###################   #  #  #       ##
#             #             #   #  #  #   @   ##
############  #  #########  ########  #   ######
#                #                        #    #
###############  ##  ##################        #
###############  ##  ####        ##########    #
#                #      #        #        #    #
#            #   #      #######  #  #######    #
#    #########                   #        #    #
#    #  #    ##################  ######  ##    #
#    #  #  ####################  #        #    #
#    #  #                        #  #######    #
#    #  #  #######  ##############        #    #
#    #  #        #  #                     #    #
#    #  ##########  #######################    #
#    #                                         #
#    ###########################################
#                                              #
################################################
