################################################
#  @                    #                      #
##############          #                      #
#            #             #####################
#  ######################                      #
#                      ##  ######     ##########                                                                            
###########  ############  #       #  #        #
########               ##  ######  #           #        
#####     #####                 #  #  ##########
#############################   #  #  #       ##
#             #             #   #  #  #   @   ##
############  #  #########  ##  ####  #   ######
#                #              #     #   #    #
###############  ######################        #
###############  ########        ##########    #
#                #      #        #        #    #
#            #   #      #######  #  #######    #
#    #########                   #        #    #
#    #  #    ##################  ######  ##    #
#    #  #  ####################  #        #    #
#    #  #                        #  #######    #
#    #  #  #######  ####  ########        #    #
#    #  #        #  #                     #    #
#    #  ##########  #######################    #
#    #                                         #
#    ######################################    #
#                                              #
################################################
