################################################
#  @                    #                      #
##############          #                      #
#            #             #####################
#  ######################                      #
#                      ##  #####################                                                                            
###########  ############          #           #
########               ##  ######  #           #        
#####     #####                 #  #  ####  ####
#######   ###################   #  #  #       ##
#             #             #   #  #  #   @   ##
############  ############  ########  #   ######
#                #                    #   #    #
###############  ##  ######  ##########        #
###############  ##  ####        ##########    #
#                #      #        #        #    #
#            #   #      #######  #  #######    #
#    #########                   #        #    #
#    #  #    ##################  ######  ##    #
#    #  #  ####################  #        #    #
#    #  #                        #  #######    #
#    #  #  #######  ##############        #    #
#    #  #        #  #                     #    #
#    #  ###################################    #
#    #                                         #
#    ######################################  ###
#                                              #
################################################
