################################################
#  @                ######                     #
####  #  #################                     #
#     #             #            ###############
#     ##########    #                          #
#     #             #########################  #
#     #             #                          #
#     ##  ######  ###  #################    ####
#     #      #      #########                  #
#     #      #                                 #
#     #      #################  ################
####                                           #
#     ######################################   #
#######                                        #
#     #################  ##############  #######
#                        #                     #
#######################  ###############       #
#                        #                     #
##  ###################  #    ##################
#                     #  #                     #
#                     #  #######################
#################                              #
#                        #######################
####  ################                        #
#                 ####################  ########
#                 #     #     #     #     # $ ##
#                    #     #     #     #      ##
################################################
