################################################
#  @                                           #
####  #  ############                          #
#     #             #            ###############
#     ##########    #                          #
#     #             #########################  #
#     #             #                          #
#     ##  ######  ###  #########################
#     #      #      #########                  #
#     #      #                                 #
#     #      #################  ################
####                                           #
#     ######################################   #
#######                                        #
#     #################  ##############  #######
#                        #                     #
#######################  ###############       #
#                        #                     #
##  ###################  #    ##################
#                     #  #                     #
#                     #  #######################
#################                              #
#                        #######################
####  ################                        #
#                 ####################  ########
#                 #     #     #     #     #   ##
#                    #     #     #     #      ##
################################################
