################################################
#  @                                           #
############################################   #
#                                              #
#  #############################################
#                                              #                                                                            
############################################   #
#                                              #        
#  #############################################                                              
#                                              #                                              
############################################   #
#                                              #
#  #############################################
#                                              #
############################################   #
#                                              #
#  #############################################
#  #                                           #
#  #                                           #
#  ######################################      #
#                                              #
#  ######################################      #
#  #                                           #      
#  #                                          #
#  ##########################  #################
#                                             ##
#                                             ##
################################################

