################################################
#                                          #   #
############################################   #
#                                            @ #
#  #############################################
#                                              #                                                                            
############################################   #
#                                              #        
#  #############################################                                              
#                                              #                                              
############################################   #
#                                              #
#  #############################################
#                                              #
############################################   #
#                                              #
#  #############################################
#  #                                           #
#  #                                           #
#  ######################################      #
#                                              #
#  ######################################      #
#  #                                           #      
#  #                                           #
#  ##########################  #################
#                                             ##
#                                           $ ##
################################################

