################################################
#  @               ######                      #
##############     ######                      #
#                               ################
#  ######################                      #
#                      ##  ######     ##########                                                                            
###########  ############  #       #  #        #
########               ##########  #           #        
#####     #####                 #  #  ##########
#######   ###################   #  #  #     $ ##
#             #             #      #  #       ##
############  #  #########  ########  #   ######
#                #                    #   #    #
###############  ##  ##################        #
###############  ##     #              ####    #
#                #      #                 #    #
#            #####      #######  #  #######    #
##  ##  ######                   #        #    #
#    #  #    ##################  ######        #
#    #  #                        #        #    #
#    #  #                        #  #######    #
#    #  #  #######################        #    #
#    #  #                                 #    #
#    #  ########################################
#    #                                         #
#    ###########################################
#                                              #
################################################
