################################################
# @                                            #
#######  ############                          #
#  $  #             #            ###############
#     ##########    #                          #
#     #             ##############             #
#     #             #                          #
#     ##########  ###           ################
#     #      #      #########                  #
#     #      #                                 #
#     #      #################  ################
#     #                                        #
#  #########################################   #
#  #  #                                        #
#  #  #################  ##############  #######
#  #                     #                     #
#  ####################  ###############       #
#      #                #                     #
##  ###################  #    ##################
#      #              #  #                     #
#           #  #      #  #################     #
#############  ########  #                     #
#                        ###########  ##########
#############  ###########                     #
#       #  #      #          ###################
#        ##       #                           ##
#        #                                    ##
################################################
