################################################
# @                                            #
#######  ############                          #
#     #             #            ###############
#     ##########    #                          #
#     #             ##############             #
#     #             #                          #
#     ##########  ###           ################
#     #      #      #########                  #
#     #      #                                 #
#     #      #################  ################
#     #                                        #
#     ######################################   #
#     #                                        #
#     #################  ##############  #######
#                        #                     #
##  ###################  ###############       #
#                        #                     #
##  ###################  #    ##################
#                     #  #                     #
#                     #  #################     #
#############  ########  #                     #
#                        ###########  ##########
#############  ###########                     #
#                 #          ###################
#                 #                           ##
#                                             ##
################################################
