################################################
#  @                                           #
#######  ############                          #
#     #             #            ###############
#     ##########    #                          #
#     #             ##############             #
#     #             #                          #
#     ##########  ###           ################
#     #      #      #########                  #
#     #      #                                 #
#     #      #################  ################
####                                           #
#     ######################################   #
#  ####                                        #
#     #################  ##############  #######
#                        #                     #
#######################  ###############       #
#                        #                     #
##  ###################  #    ##################
#                     #  #                     #
#                     #  #################     #
#################  #######                     #
#                        ###########  ##########
####  ####################                     #
#                 ##############################
#                 #     #     #     #     # $ ##
#                    #     #     #     #      ##
################################################
